01 01 01 01 01 01 01 01 01 01 01 01 01 01 01
06 02 02 02 02 02 02 02 02 02 02 02 02 02 07
03 10 10 00 10 00 00 10 10 00 00 10 10 10 04
03 10 01 00 01 10 01 10 01 00 01 10 01 10 04
03 10 00 10 10 00 10 10 10 00 10 00 00 10 04
03 00 01 00 01 10 01 10 01 10 01 00 01 10 04
03 10 00 10 10 00 10 00 10 10 10 10 10 10 04
03 10 01 10 01 00 01 10 01 00 01 10 01 00 04
03 00 10 10 10 10 00 10 10 10 10 10 10 10 04
03 10 01 10 01 10 01 00 01 10 01 10 01 10 04
03 10 10 10 00 10 00 10 10 10 10 10 00 10 04 
03 10 01 10 01 00 01 00 01 10 01 10 01 10 04
03 10 10 10 00 00 10 10 10 10 10 00 00 10 04
05 05 05 05 05 05 05 05 05 05 05 05 05 05 05